[
  {
    "id": 1,
    "name": "Ship",
    "grid": [
      [0, 0, 0, 0, 0, 1, 1, 1, 0, 0],
      [0, 0, 0, 0, 1, 1, 1, 1, 0, 0],
      [0, 0, 0, 1, 1, 0, 0, 1, 1, 0],
      [0, 0, 0, 1, 1, 0, 0, 1, 1, 0],
      [0, 0, 1, 1, 0, 0, 0, 0, 1, 1],
      [1, 1, 1, 0, 0, 0, 0, 0, 1, 1],
      [0, 1, 1, 0, 0, 0, 0, 0, 1, 1],
      [0, 0, 0, 1, 1, 0, 0, 1, 1, 0],
      [0, 0, 0, 0, 1, 0, 0, 1, 0, 0],
      [0, 0, 0, 0, 0, 1, 1, 1, 0, 0]
    ]
  },
  {
    "id": 2,
    "name": "House",
    "grid": [
      [0, 0, 0, 0, 0, 1, 1, 0, 0, 0],
      [0, 0, 0, 0, 1, 1, 1, 1, 0, 0],
      [0, 0, 0, 1, 1, 1, 1, 1, 0, 0],
      [0, 0, 1, 1, 1, 1, 1, 1, 1, 0],
      [0, 1, 1, 1, 1, 1, 1, 1, 1, 1],
      [0, 1, 1, 1, 1, 1, 1, 1, 1, 1],
      [1, 0, 1, 1, 1, 1, 1, 1, 1, 0],
      [0, 0, 1, 1, 1, 1, 1, 1, 1, 0],
      [0, 0, 0, 1, 1, 1, 1, 1, 0, 0],
      [0, 0, 0, 0, 0, 1, 1, 0, 0, 0]
    ]
  },
  {
    "id": 3,
    "name": "Tree",
    "grid": [
      [0, 0, 0, 0, 0, 0, 0, 0, 0, 0],
      [0, 0, 0, 0, 1, 1, 1, 0, 0, 0],
      [0, 0, 0, 1, 1, 1, 1, 1, 0, 0],
      [0, 0, 1, 1, 1, 1, 1, 1, 1, 0],
      [0, 0, 0, 1, 1, 0, 1, 1, 0, 0],
      [0, 0, 0, 0, 0, 0, 0, 0, 0, 0],
      [0, 0, 0, 1, 1, 1, 1, 1, 0, 0],
      [0, 0, 0, 0, 0, 0, 0, 0, 0, 0],
      [0, 0, 0, 1, 1, 1, 1, 1, 0, 0],
      [0, 0, 0, 0, 1, 1, 1, 0, 0, 0]
    ]
  },
  {
    "id": 4,
    "name": "Cat",
    "grid": [
      [0, 0, 0, 0, 0, 1, 1, 0, 0, 0],
      [0, 0, 0, 0, 1, 1, 1, 1, 0, 0],
      [0, 0, 0, 1, 1, 1, 1, 1, 0, 0],
      [0, 0, 1, 1, 1, 1, 1, 1, 1, 0],
      [0, 1, 1, 1, 1, 1, 1, 1, 1, 1],
      [0, 0, 0, 1, 1, 1, 1, 1, 0, 0],
      [0, 0, 1, 1, 1, 1, 1, 1, 0, 0],
      [0, 0, 0, 1, 1, 1, 1, 0, 0, 0],
      [0, 0, 0, 0, 1, 1, 0, 0, 0, 0],
      [0, 0, 0, 0, 0, 0, 0, 0, 0, 0]
    ]
  },
  {
    "id": 5,
    "name": "Car",
    "grid": [
      [0, 0, 0, 0, 1, 1, 0, 0, 0, 0],
      [0, 0, 0, 1, 1, 1, 1, 1, 0, 0],
      [0, 0, 1, 1, 1, 1, 1, 1, 1, 0],
      [0, 1, 1, 1, 1, 1, 1, 1, 1, 1],
      [1, 1, 1, 1, 1, 1, 1, 1, 1, 1],
      [1, 1, 1, 1, 1, 1, 1, 1, 1, 1],
      [0, 0, 1, 1, 1, 1, 1, 1, 0, 0],
      [0, 0, 0, 1, 1, 1, 1, 0, 0, 0],
      [0, 0, 0, 0, 1, 1, 0, 0, 0, 0],
      [0, 0, 0, 0, 0, 0, 0, 0, 0, 0]
    ]
  },
  {
    "id": 6,
    "name": "Dog",
    "grid": [
      [0, 0, 0, 0, 0, 0, 0, 0, 0, 0],
      [0, 0, 0, 0, 1, 1, 1, 0, 0, 0],
      [0, 0, 0, 1, 1, 1, 1, 1, 0, 0],
      [0, 0, 1, 1, 1, 1, 1, 1, 1, 0],
      [0, 1, 1, 1, 1, 1, 1, 1, 1, 1],
      [0, 1, 1, 1, 1, 1, 1, 1, 1, 1],
      [0, 1, 1, 1, 1, 1, 1, 1, 1, 1],
      [0, 0, 1, 1, 1, 1, 1, 1, 0, 0],
      [0, 0, 0, 1, 1, 1, 1, 0, 0, 0],
      [0, 0, 0, 0, 0, 1, 0, 0, 0, 0]
    ]
  },
  {
    "id": 7,
    "name": "Rocket",
    "grid": [
      [0, 0, 0, 0, 0, 0, 0, 0, 0, 0],
      [0, 0, 0, 1, 1, 1, 1, 0, 0, 0],
      [0, 0, 1, 1, 1, 1, 1, 1, 0, 0],
      [0, 1, 1, 1, 1, 1, 1, 1, 1, 0],
      [1, 1, 1, 1, 1, 1, 1, 1, 1, 1],
      [1, 1, 1, 1, 1, 1, 1, 1, 1, 1],
      [0, 0, 1, 1, 1, 1, 1, 1, 0, 0],
      [0, 0, 1, 1, 1, 1, 1, 1, 0, 0],
      [0, 0, 0, 1, 1, 1, 1, 0, 0, 0],
      [0, 0, 0, 0, 1, 1, 0, 0, 0, 0]
    ]
  },
  {
    "id": 8,
    "name": "Flower",
    "grid": [
      [0, 0, 0, 0, 0, 1, 1, 0, 0, 0],
      [0, 0, 0, 0, 1, 1, 1, 1, 0, 0],
      [0, 0, 0, 0, 1, 1, 1, 1, 0, 0],
      [0, 0, 0, 0, 0, 1, 1, 0, 0, 0],
      [0, 0, 1, 1, 1, 1, 1, 1, 1, 0],
      [0, 1, 1, 1, 1, 1, 1, 1, 1, 1],
      [0, 0, 1, 1, 1, 1, 1, 1, 1, 0],
      [0, 0, 0, 1, 1, 1, 1, 1, 0, 0],
      [0, 0, 1, 1, 0, 0, 1, 1, 0, 0],
      [0, 0, 0, 0, 0, 0, 0, 0, 0, 0]
    ]
  },
  {
    "id": 9,
    "name": "Sun",
    "grid": [
      [0, 0, 0, 1, 1, 1, 1, 0, 0, 0],
      [0, 0, 1, 1, 1, 1, 1, 1, 0, 0],
      [0, 1, 1, 1, 1, 1, 1, 1, 1, 0],
      [0, 1, 1, 1, 1, 1, 1, 1, 1, 0],
      [0, 1, 1, 1, 1, 1, 1, 1, 1, 0],
      [1, 1, 1, 1, 1, 1, 1, 1, 1, 1],
      [0, 1, 1, 1, 1, 1, 1, 1, 1, 0],
      [0, 1, 1, 1, 1, 1, 1, 1, 0, 0],
      [0, 0, 1, 1, 1, 1, 1, 0, 0, 0],
      [0, 0, 0, 1, 1, 1, 0, 0, 0, 0]
    ]
  },
  {
    "id": 10,
    "name": "Heart",
    "grid": [
      [0, 0, 0, 0, 0, 0, 0, 0, 0, 0],
      [0, 0, 1, 1, 0, 0, 1, 1, 0, 0],
      [0, 1, 1, 1, 1, 1, 1, 1, 1, 0],
      [0, 1, 1, 1, 1, 1, 1, 1, 1, 0],
      [0, 0, 1, 1, 1, 1, 1, 1, 0, 0],
      [0, 0, 0, 1, 1, 1, 1, 0, 0, 0],
      [0, 0, 0, 0, 1, 1, 0, 0, 0, 0],
      [0, 0, 0, 0, 0, 0, 0, 0, 0, 0]
    ]
  }
]
